{
    "enemies": [
        {
            "type": "Pink Guy",
            "coordinates": [350, 150]
        }
    ],
    "map": {
        "background": [
            ["xx", "xx", "xx", "xx", "xx", "xx", "xx", "xx", "xx", "xx", "xx", "xx", "xx", "xx", "xx", "xx", "xx", "xx", "xx", "xx"],
            ["xx", "xx", "xx", "xx", "xx", "xx", "xx", "xx", "xx", "xx", "xx", "xx", "xx", "xx", "xx", "xx", "xx", "xx", "xx", "xx"],
            ["  ", "  ", "  ", "  ", "  ", "  ", "  ", "  ", "  ", "  ", "  ", "  ", "  ", "  ", "  ", "  ", "  ", "  ", "  ", "  "],
            ["  ", "wl", "wl", "wl", "wl", "wl", "wl", "wl", "wl", "wl", "wl", "wl", "wl", "wl", "wl", "wl", "wl", "wl", "wl", "  "],
            ["  ", "wl", "wl", "wl", "wl", "wl", "wl", "wl", "wl", "wl", "wl", "wl", "wl", "wl", "wl", "wl", "wl", "wl", "wl", "  "],
            ["  ", "wl", "wl", "wl", "wl", "wl", "wl", "wl", "wl", "wl", "wl", "wl", "wl", "wl", "wl", "wl", "wl", "wl", "wl", "  "],
            ["  ", "wl", "wl", "wl", "wl", "wl", "wl", "wl", "wl", "wl", "wl", "wl", "wl", "wl", "wl", "wl", "wl", "wl", "wl", "  "],
            ["  ", "wl", "wl", "bw", "wl", "bw", "wl", "bw", "wl", "1w", "wl", "wl", "wl", "wl", "wl", "wl", "wl", "wl", "wl", "  "],
            ["  ", "wl", "wl", "wl", "wl", "wl", "wl", "wl", "wl", "wb", "wl", "wl", "wl", "wl", "wl", "wl", "wl", "wl", "wl", "  "],
            ["  ", "  ", "  ", "  ", "wl", "  ", "wl", "  ", "wl", "  ", "wl", "  ", "  ", "  ", "  ", "  ", "  ", "  ", "  ", "  "],
            ["xx", "xx", "xx", "xx", "xx", "xx", "xx", "xx", "xx", "xx", "xx", "xx", "xx", "xx", "xx", "xx", "xx", "xx", "xx", "xx"],
            ["xx", "xx", "xx", "xx", "xx", "xx", "xx", "xx", "xx", "xx", "xx", "xx", "xx", "xx", "xx", "xx", "xx", "xx", "xx", "xx"]
        ],
        "decorations": [
            ["  ", "  ", "  ", "  ", "  ", "  ", "  ", "  ", "  ", "  ", "  ", "  ", "  ", "  ", "  ", "  ", "  ", "  ", "  ", "  "],
            ["  ", "  ", "  ", "  ", "  ", "  ", "  ", "  ", "  ", "  ", "  ", "  ", "  ", "  ", "  ", "  ", "  ", "  ", "  ", "  "],
            ["  ", "  ", "  ", "  ", "  ", "  ", "  ", "  ", "  ", "  ", "  ", "  ", "  ", "  ", "  ", "  ", "  ", "  ", "  ", "  "],
            ["  ", "  ", "  ", "  ", "  ", "  ", "  ", "  ", "  ", "  ", "  ", "  ", "  ", "  ", "  ", "  ", "  ", "  ", "  ", "  "],
            ["  ", "  ", "  ", "  ", "  ", "  ", "  ", "  ", "  ", "  ", "  ", "  ", "  ", "  ", "  ", "  ", "  ", "  ", "  ", "  "],
            ["  ", "  ", "  ", "  ", "  ", "  ", "  ", "  ", "  ", "  ", "  ", "  ", "  ", "  ", "  ", "  ", "  ", "  ", "  ", "  "],
            ["  ", "  ", "  ", "  ", "  ", "  ", "  ", "  ", "  ", "  ", "  ", "  ", "  ", "  ", "  ", "  ", "  ", "  ", "  ", "  "],
            ["  ", "  ", "  ", "  ", "  ", "  ", "  ", "  ", "  ", "  ", "  ", "  ", "  ", "  ", "  ", "  ", "  ", "  ", "  ", "  "],
            ["  ", "  ", "  ", "  ", "  ", "  ", "  ", "  ", "  ", "  ", "  ", "  ", "  ", "  ", "  ", "  ", "  ", "  ", "  ", "  "],
            ["  ", "  ", "  ", "  ", "  ", "  ", "  ", "  ", "  ", "  ", "  ", "  ", "  ", "  ", "  ", "  ", "  ", "  ", "  ", "  "],
            ["  ", "  ", "  ", "  ", "  ", "  ", "  ", "  ", "  ", "  ", "  ", "  ", "  ", "  ", "  ", "  ", "  ", "  ", "  ", "  "],
            ["  ", "  ", "  ", "  ", "  ", "  ", "  ", "  ", "  ", "  ", "  ", "  ", "  ", "  ", "  ", "  ", "  ", "  ", "  ", "  "]
        ],
        "terrain": [
            ["  ", "  ", "  ", "  ", "  ", "  ", "  ", "  ", "  ", "  ", "  ", "  ", "  ", "  ", "  ", "  ", "  ", "  ", "  ", "  "],
            ["  ", "  ", "  ", "  ", "  ", "  ", "  ", "  ", "  ", "  ", "  ", "  ", "  ", "  ", "  ", "  ", "  ", "  ", "  ", "  "],
            ["k1", "k2", "c1", "c1", "c1", "c1", "c1", "c1", "c1", "c1", "c1", "c1", "c1", "c1", "c1", "c1", "c1", "c1", "k5", "k6"],
            ["k3", "k4", "  ", "  ", "  ", "  ", "  ", "  ", "  ", "  ", "  ", "  ", "  ", "  ", "  ", "  ", "  ", "  ", "k7", "k8"],
            ["l1", "  ", "  ", "  ", "  ", "  ", "  ", "  ", "  ", "  ", "  ", "  ", "  ", "  ", "  ", "  ", "  ", "  ", "  ", "r1"],
            ["l1", "  ", "  ", "  ", "CN", "  ", "CN", "  ", "CN", "  ", "  ", "  ", "  ", "  ", "  ", "  ", "  ", "  ", "  ", "r1"],
            ["l1", "  ", "  ", "  ", "  ", "  ", "  ", "  ", "  ", "  ", "  ", "  ", "  ", "  ", "  ", "  ", "  ", "  ", "  ", "r1"],
            ["l1", "  ", "  ", "  ", "  ", "  ", "  ", "  ", "  ", "  ", "  ", "  ", "  ", "  ", "  ", "  ", "  ", "  ", "  ", "r1"],
            ["l1", "  ", "  ", "  ", "  ", "  ", "  ", "  ", "  ", "  ", "  ", "  ", "  ", "  ", "  ", "  ", "  ", "GW", "  ", "r1"],
            ["bl", "f1", "f1", "f1", "  ", "f1", "  ", "f1", "  ", "f1", "  ", "f1", "f1", "f1", "f1", "f1", "f1", "f1", "f1", "br"],
            ["  ", "  ", "  ", "  ", "  ", "  ", "  ", "  ", "  ", "  ", "  ", "  ", "  ", "  ", "  ", "  ", "  ", "  ", "  ", "  "],
            ["  ", "  ", "  ", "  ", "  ", "  ", "  ", "  ", "  ", "  ", "  ", "  ", "  ", "  ", "  ", "  ", "  ", "  ", "  ", "  "]
        ]
    },
    "starting_position": [50, 200]
}